Recorder,Recordee,Contact Time,Start,End,Order,ICT
2,1,7,5237,5244,1,0
2,1,0,14876,14876,2,9632
2,1,0,17595,17595,3,2719
2,1,0,18045,18045,4,450
2,1,0,22050,22050,5,4005
2,1,351,84191,84542,6,62141
2,1,0,86911,86911,7,2369
2,1,0,87505,87505,8,594
2,1,0,90378,90378,9,2873
2,1,232,90848,91080,10,470
2,1,0,100425,100425,11,9345
2,1,226,103098,103324,12,2673
2,1,0,109868,109868,13,6544
2,1,109,110222,110331,14,354
2,1,124,110953,111077,15,622
2,1,621,115840,116461,16,4763
2,1,236,119218,119454,17,2757
2,1,0,337330,337330,18,217876
2,1,0,338556,338556,19,1226
2,1,0,341078,341078,20,2522
2,1,0,345133,345133,21,4055
2,1,0,345632,345632,22,499
2,1,0,346216,346216,23,584
2,1,7,346557,346564,24,341
2,1,0,347044,347044,25,480
2,1,1085,347538,348623,26,494
2,1,945,348864,349809,27,241
2,1,368,350295,350663,28,486
2,1,492,351389,351881,29,726
2,1,0,352123,352123,30,242
2,1,0,353818,353818,31,1695
2,1,0,354763,354763,32,945
3,1,115,121,236,1,0
3,1,0,585,585,2,349
3,1,0,87156,87156,3,86571
3,1,5284,96104,101388,4,8948
3,1,5410,101632,107042,5,244
3,1,9149,107414,116563,6,372
4,1,0,943,943,1,0
4,1,0,1433,1433,2,490
4,1,243,8379,8622,3,6946
4,1,1077,8863,9940,4,241
4,1,480,10058,10538,5,118
4,1,229,10890,11119,6,352
4,1,253,11566,11819,7,447
4,1,629,12401,13030,8,582
4,1,6,13491,13497,9,461
4,1,0,14000,14000,10,503
4,1,0,14245,14245,11,245
4,1,0,14720,14720,12,475
4,1,811,14851,15662,13,131
4,1,124,16003,16127,14,341
4,1,0,16362,16362,15,235
4,1,117,16491,16608,16,129
4,1,356,16943,17299,17,335
4,1,0,17532,17532,18,233
4,1,626,17664,18290,19,132
4,1,722,18530,19252,20,240
4,1,1694,19700,21394,21,448
4,1,2667,21752,24419,22,358
4,1,1057,24679,25736,23,260
4,1,0,25971,25971,24,235
4,1,354,86231,86585,25,60260
4,1,1194,86927,88121,26,342
4,1,3116,96955,100071,27,8834
4,1,3893,100310,104203,28,239
4,1,600,104340,104940,29,137
4,1,1229,105271,106500,30,331
4,1,6928,106991,113919,31,491
4,1,2731,114269,117000,32,350
4,1,237,117343,117580,33,343
4,1,483,117711,118194,34,131
4,1,227,118327,118554,35,133
4,1,481,188093,188574,36,69539
5,1,0,1432,1432,1,0
5,1,120,1784,1904,2,352
5,1,0,8613,8613,3,6709
5,1,1682,8868,10550,4,255
5,1,596,10911,11507,5,361
5,1,942,11751,12693,6,244
5,1,631,13042,13673,7,349
5,1,468,14281,14749,8,608
5,1,370,15016,15386,9,267
5,1,621,16130,16751,10,744
5,1,1283,17113,18396,11,362
5,1,237,18644,18881,12,248
5,1,245,22755,23000,13,3874
6,1,0,4016,4016,1,0
6,1,0,4374,4374,2,358
6,1,0,4752,4752,3,378
7,1,0,10674,10674,1,0
7,1,0,11384,11384,2,710
7,1,0,13037,13037,3,1653
7,1,0,15270,15270,4,2233
7,1,7,16258,16265,5,988
7,1,0,16997,16997,6,732
7,1,0,18656,18656,7,1659
7,1,239,19109,19348,8,453
7,1,249,19837,20086,9,489
7,1,134,20461,20595,10,375
7,1,0,20958,20958,11,363
7,1,0,21324,21324,12,366
7,1,121,21689,21810,13,365
7,1,0,248815,248815,14,227005
7,1,0,250003,250003,15,1188
7,1,124,258778,258902,16,8775
7,1,0,261544,261544,17,2642
7,1,4,262144,262148,18,600
7,1,127,262636,262763,19,488
7,1,0,265260,265260,20,2497
7,1,0,266127,266127,21,867
7,1,0,268437,268437,22,2310
7,1,927,268569,269496,23,132
7,1,0,270442,270442,24,946
7,1,253,272347,272600,25,1905
7,1,0,272967,272967,26,367
8,1,256,4250,4506,1,0
8,1,481,5254,5735,2,748
8,1,118,5975,6093,3,240
8,1,121,6449,6570,4,356
8,1,0,6912,6912,5,342
8,1,0,7377,7377,6,465
8,1,486,8112,8598,7,735
8,1,0,9326,9326,8,728
8,1,625,10036,10661,9,710
8,1,0,13298,13298,10,2637
8,1,134,21232,21366,11,7934
8,1,5,22210,22215,12,844
8,1,5,23058,23063,13,843
8,1,0,262105,262105,14,239042
8,1,0,269054,269054,15,6949
8,1,7,273747,273754,16,4693
8,1,134,337296,337430,17,63542
8,1,115,339120,339235,18,1690
8,1,0,343182,343182,19,3947
8,1,350,347849,348199,20,4667
8,1,14,349290,349304,21,1091
8,1,130,350997,351127,22,1693
8,1,0,351740,351740,23,613
8,1,0,354949,354949,24,3209
9,1,0,86488,86488,1,0
9,1,122,115736,115858,2,29248
9,1,0,181087,181087,3,65229
1,2,0,1306,1306,1,0
1,2,0,2387,2387,2,1081
1,2,0,10674,10674,3,8287
1,2,0,10911,10911,4,237
1,2,14,18015,18029,5,7104
1,2,0,82948,82948,6,64919
1,2,0,83315,83315,7,367
1,2,7,83681,83688,8,366
1,2,0,86401,86401,9,2713
1,2,355,86763,87118,10,362
1,2,0,95973,95973,11,8855
1,2,21,96335,96356,12,362
1,2,0,99100,99100,13,2744
1,2,0,104261,104261,14,5161
1,2,252,106265,106517,15,2004
1,2,0,107129,107129,16,612
1,2,0,107527,107527,17,398
1,2,592,111806,112398,18,4279
1,2,0,115336,115336,19,2938
3,2,116,17727,17843,1,0
3,2,0,83589,83589,2,65746
3,2,222,86485,86707,3,2896
3,2,0,87156,87156,4,449
3,2,119,87522,87641,5,366
3,2,0,88337,88337,6,696
3,2,127,88826,88953,7,489
3,2,253,89308,89561,8,355
3,2,2155,89911,92066,9,350
3,2,958,92416,93374,10,350
3,2,360,93867,94227,11,493
3,2,115,94478,94593,12,251
3,2,0,94723,94723,13,130
3,2,254,94858,95112,14,135
3,2,147,95592,95739,15,480
3,2,0,96815,96815,16,1076
3,2,348,97306,97654,17,491
3,2,1294,98024,99318,18,370
3,2,0,99560,99560,19,242
3,2,0,99912,99912,20,352
3,2,0,100050,100050,21,138
3,2,122,100175,100297,22,125
3,2,1668,101505,103173,23,1208
3,2,602,103416,104018,24,243
3,2,0,104375,104375,25,357
3,2,234,104827,105061,26,452
3,2,483,106032,106515,27,971
3,2,391,106651,107042,28,136
3,2,0,107667,107667,29,625
3,2,363,108530,108893,30,863
3,2,463,109016,109479,31,123
3,2,247,109956,110203,32,477
3,2,996,110452,111448,33,249
3,2,586,111789,112375,34,341
3,2,1045,113450,114495,35,1075
3,2,127,114851,114978,36,356
3,2,254,115219,115473,37,241
3,2,2297,198078,200375,38,82605
3,2,965,200612,201577,39,237
3,2,0,202530,202530,40,953
3,2,0,203848,203848,41,1318
3,2,234,205546,205780,42,1698
3,2,1086,206028,207114,43,248
4,2,0,11566,11566,1,0
4,2,0,11814,11814,2,248
4,2,498,88121,88619,3,76307
4,2,360,88966,89326,4,347
4,2,1860,89569,91429,5,243
4,2,370,91780,92150,6,351
4,2,124,92167,92291,7,17
4,2,221,92415,92636,8,124
4,2,249,92996,93245,9,360
4,2,944,93486,94430,10,241
4,2,1314,94786,96100,11,356
4,2,249,96594,96843,12,494
4,2,0,97322,97322,13,479
4,2,5,100071,100076,14,2749
4,2,117,112746,112863,15,12670
4,2,114,116295,116409,16,3432
5,2,0,11635,11635,1,0
5,2,0,15004,15004,2,3369
6,2,121,464,585,1,0
6,2,233,1905,2138,2,1320
6,2,0,90368,90368,3,88230
6,2,0,91194,91194,4,826
6,2,375,92527,92902,5,1333
6,2,713,93143,93856,6,241
6,2,380,94224,94604,7,368
6,2,516,95216,95732,8,612
6,2,121,96231,96352,9,499
6,2,848,96714,97562,10,362
6,2,837,97811,98648,11,249
6,2,231,98891,99122,12,243
7,2,0,1785,1785,1,0
7,2,113,1915,2028,2,130
7,2,349,2144,2493,3,116
7,2,1182,2842,4024,4,349
7,2,4475,4382,8857,5,358
7,2,0,10794,10794,6,1937
7,2,0,11742,11742,7,948
7,2,246,12198,12444,8,456
7,2,7,13037,13044,9,593
7,2,0,13927,13927,10,883
7,2,128,16265,16393,11,2338
7,2,110,17574,17684,12,1181
7,2,7,19102,19109,13,1418
7,2,0,19467,19467,14,358
7,2,0,19837,19837,15,370
7,2,261,20327,20588,16,490
7,2,126,20832,20958,17,244
7,2,0,21924,21924,18,966
7,2,114,252876,252990,19,230952
7,2,246,254091,254337,20,1101
7,2,0,258778,258778,21,4441
7,2,1452,259128,260580,22,350
7,2,0,261191,261191,23,611
7,2,121,261664,261785,24,473
7,2,127,262509,262636,25,724
7,2,733,263002,263735,26,366
7,2,116,264092,264208,27,357
7,2,0,264811,264811,28,603
7,2,485,265871,266356,29,1060
7,2,0,266714,266714,30,358
7,2,0,267186,267186,31,472
7,2,0,268444,268444,32,1258
7,2,352,268807,269159,33,363
7,2,1062,269496,270558,34,337
7,2,463,271884,272347,35,1326
7,2,0,273691,273691,36,1344
8,2,714,347,1061,1,0
8,2,352,1429,1781,2,368
8,2,110,2027,2137,3,246
8,2,0,22095,22095,4,19958
8,2,232,338281,338513,5,316186
8,2,0,344979,344979,6,6466
9,2,0,82983,82983,1,0
9,2,0,85898,85898,2,2915
9,2,1273,86598,87871,3,700
9,2,611,88217,88828,4,346
9,2,0,89560,89560,5,732
9,2,1171,89910,91081,6,350
9,2,1807,91331,93138,7,250
9,2,121,93497,93618,8,359
9,2,11,93864,93875,9,246
9,2,876,94353,95229,10,478
9,2,0,103697,103697,11,8468
9,2,249,111838,112087,12,8141
9,2,124,112428,112552,13,341
9,2,461,197659,198120,14,85107
9,2,0,198595,198595,15,475
9,2,0,199794,199794,16,1199
9,2,117,200051,200168,17,257
9,2,0,200515,200515,18,347
9,2,0,201610,201610,19,1095
9,2,0,206419,206419,20,4809
9,2,593,249991,250584,21,43572
9,2,1434,250958,252392,22,374
9,2,1227,252743,253970,23,351
9,2,829,254568,255397,24,598
9,2,4588,255745,260333,25,348
9,2,1183,260714,261897,26,381
9,2,1583,262385,263968,27,488
9,2,232,264339,264571,28,371
9,2,14,265864,265878,29,1293
9,2,355,266829,267184,30,951
9,2,1939,267433,269372,31,249
9,2,121,269722,269843,32,350
9,2,3134,270318,273452,33,475
9,2,242,273809,274051,34,357
1,3,111,236,347,1,0
1,3,351,589,940,2,242
1,3,109,87118,87227,3,86178
1,3,3375,95973,99348,4,8746
1,3,7066,99808,106874,5,460
1,3,145,107129,107274,6,255
1,3,632,107520,108152,7,246
1,3,7919,108639,116558,8,487
2,3,115,121,236,1,0
2,3,0,589,589,2,353
2,3,0,21802,21802,3,21213
2,3,119,90490,90609,4,68688
2,3,361,91316,91677,5,707
2,3,0,92186,92186,6,509
2,3,6449,92661,99110,7,475
2,3,342,99474,99816,8,364
2,3,112,100425,100537,9,609
2,3,0,100665,100665,10,128
2,3,0,100904,100904,11,239
2,3,1818,101040,102858,12,136
2,3,940,103331,104271,13,473
2,3,0,104642,104642,14,371
2,3,1045,105002,106047,15,360
2,3,721,106404,107125,16,357
2,3,14,107387,107401,17,262
2,3,0,107660,107660,18,259
2,3,118,108164,108282,19,504
2,3,0,108763,108763,20,481
2,3,0,110222,110222,21,1459
2,3,503,110574,111077,22,352
2,3,0,111810,111810,23,733
2,3,357,112064,112421,24,254
2,3,0,113118,113118,25,697
2,3,607,113711,114318,26,593
2,3,1436,114892,116328,27,574
2,3,126,117434,117560,28,1106
2,3,120,117812,117932,29,252
2,3,1060,118394,119454,30,462
2,3,3368,202191,205559,31,82737
2,3,0,206646,206646,32,1087
2,3,120,209427,209547,33,2781
2,3,1308,209913,211221,34,366
2,3,0,336711,336711,35,125490
2,3,7,337323,337330,36,612
2,3,0,338779,338779,37,1449
2,3,0,339162,339162,38,383
2,3,0,339521,339521,39,359
2,3,0,340610,340610,40,1089
2,3,225,340968,341193,41,358
2,3,611,345133,345744,42,3940
2,3,228,345988,346216,43,244
2,3,354,346564,346918,44,348
2,3,848,347412,348260,45,494
2,3,126,348497,348623,46,237
2,3,223,348864,349087,47,241
2,3,2309,349565,351874,48,478
2,3,130,352123,352253,49,249
2,3,0,352622,352622,50,369
2,3,0,352988,352988,51,366
2,3,0,353339,353339,52,351
2,3,0,353708,353708,53,369
2,3,225,353941,354166,54,233
2,3,120,354643,354763,55,477
2,3,0,355475,355475,56,712
2,3,0,356070,356070,57,595
2,3,0,358237,358237,58,2167
2,3,0,358973,358973,59,736
4,3,600,1065,1665,1,0
4,3,1080,88246,89326,2,86581
4,3,2224,89686,91910,3,360
4,3,1571,92150,93721,4,240
4,3,955,94078,95033,5,357
4,3,12,95493,95505,6,460
4,3,0,96087,96087,7,582
4,3,120,96219,96339,8,132
4,3,2642,96594,99236,9,255
4,3,231,99472,99703,10,236
4,3,3278,100192,103470,11,489
4,3,1925,103830,105755,12,360
4,3,4070,106003,110073,13,248
4,3,0,110419,110419,14,346
4,3,119,110902,111021,15,483
4,3,840,111267,112107,16,246
4,3,3232,112236,115468,17,129
4,3,121,115708,115829,18,240
4,3,1157,116186,117343,19,357
5,3,589,1308,1897,1,0
6,3,124,464,588,1,0
6,3,127,4374,4501,2,3786
6,3,0,4752,4752,3,251
6,3,0,92307,92307,4,87555
6,3,0,92654,92654,5,347
6,3,1205,92902,94107,6,248
6,3,1226,94238,95464,7,131
6,3,3397,95725,99122,8,261
7,3,3481,1785,5266,1,0
7,3,255,5509,5764,2,243
7,3,1066,6002,7068,3,238
7,3,961,7405,8366,4,337
7,3,237,8620,8857,5,254
7,3,0,9939,9939,6,1082
7,3,0,10794,10794,7,855
7,3,715,11855,12570,8,1061
7,3,258,13030,13288,9,460
7,3,248,13679,13927,10,391
7,3,0,14893,14893,11,966
7,3,0,15525,15525,12,632
7,3,380,16140,16520,13,615
7,3,698,16876,17574,14,356
7,3,477,17803,18280,15,229
7,3,920,18656,19576,16,376
7,3,361,19959,20320,17,383
7,3,370,20588,20958,18,268
7,3,486,21324,21810,19,366
7,3,0,22258,22258,20,448
7,3,231,248584,248815,21,226326
7,3,258,249170,249428,22,355
7,3,353,249772,250125,23,344
7,3,0,250831,250831,24,706
7,3,349,258902,259251,25,8071
7,3,242,259513,259755,26,262
7,3,0,260225,260225,27,470
7,3,367,260707,261074,28,482
7,3,229,261435,261664,29,361
7,3,365,262144,262509,30,480
7,3,492,262763,263255,31,254
7,3,473,263626,264099,32,371
7,3,111,264811,264922,33,712
7,3,0,265260,265260,34,338
7,3,124,265871,265995,35,611
7,3,706,266247,266953,36,252
7,3,133,267557,267690,37,604
7,3,0,267828,267828,38,138
7,3,132,268437,268569,39,609
7,3,687,268920,269607,40,351
7,3,599,270086,270685,41,479
7,3,0,271175,271175,42,490
7,3,704,271643,272347,43,468
7,3,0,272967,272967,44,620
7,3,0,273691,273691,45,724
8,3,226,121,347,1,0
8,3,0,588,588,2,241
8,3,0,4137,4137,3,3549
8,3,120,4380,4500,4,243
8,3,0,4624,4624,5,124
8,3,0,4756,4756,6,132
8,3,134,337296,337430,7,332540
8,3,0,343182,343182,8,5752
8,3,350,347849,348199,9,4667
8,3,14,349290,349304,10,1091
8,3,0,351004,351004,11,1700
8,3,0,351496,351496,12,492
8,3,0,351740,351740,13,244
9,3,6378,121,6499,1,0
9,3,583,6855,7438,2,356
9,3,12178,7779,19957,3,341
9,3,6946,20098,27044,4,141
9,3,3206,27293,30499,5,249
9,3,7875,30743,38618,6,244
9,3,4169,38850,43019,7,232
9,3,1346,43365,44711,8,346
9,3,10404,45306,55710,9,595
9,3,3275,55952,59227,10,242
9,3,1330,59583,60913,11,356
9,3,1274,61278,62552,12,365
9,3,2431,62908,65339,13,356
9,3,2672,65712,68384,14,373
9,3,4143,68635,72778,15,251
9,3,12533,72902,85435,16,124
9,3,599,85771,86370,17,336
9,3,335,86710,87045,18,340
9,3,355,87407,87762,19,362
9,3,2037,87990,90027,20,228
9,3,241,90255,90496,21,228
9,3,976,90845,91821,22,349
9,3,2926,92303,95229,23,482
9,3,7,115736,115743,24,20507
9,3,484,115989,116473,25,246
9,3,12783,116822,129605,26,349
9,3,10179,129958,140137,27,353
9,3,1997,140503,142500,28,366
9,3,6341,142854,149195,29,354
9,3,0,149544,149544,30,349
9,3,119,149798,149917,31,254
9,3,1732,150292,152024,32,375
9,3,2421,152162,154583,33,138
9,3,4899,154959,159858,34,376
9,3,231,160103,160334,35,245
9,3,3260,160829,164089,36,495
9,3,1432,164226,165658,37,137
9,3,2944,165900,168844,38,242
9,3,1448,189058,190506,39,20214
9,3,2318,190984,193302,40,478
9,3,1761,193537,195298,41,235
9,3,1179,195653,196832,42,355
9,3,355,198484,198839,43,1652
9,3,362,200284,200646,44,1445
9,3,0,202209,202209,45,1563
9,3,1088,202564,203652,46,355
9,3,0,203892,203892,47,240
9,3,960,204130,205090,48,238
9,3,1330,205219,206549,49,129
9,3,0,206903,206903,50,354
9,3,0,208123,208123,51,1220
9,3,0,208378,208378,52,255
9,3,2026,209210,211236,53,832
9,3,1086,211586,212672,54,350
9,3,0,213637,213637,55,965
9,3,1894,213992,215886,56,355
9,3,234,216242,216476,57,356
9,3,5101,216809,221910,58,333
9,3,245,222156,222401,59,246
9,3,2927,222782,225709,60,381
9,3,227,225962,226189,61,253
9,3,946,226541,227487,62,352
9,3,3210,227826,231036,63,339
9,3,5664,231519,237183,64,483
9,3,866,237538,238404,65,355
9,3,2029,238752,240781,66,348
9,3,1913,241031,242944,67,250
9,3,129,243294,243423,68,350
9,3,2383,243684,246067,69,261
9,3,348,246422,246770,70,355
9,3,1311,247257,248568,71,487
1,4,111,236,347,1,0
1,4,351,589,940,2,242
1,4,1677,7428,9105,3,6488
1,4,9847,9476,19323,4,371
1,4,1601,19577,21178,5,254
1,4,950,21426,22376,6,248
1,4,2551,22614,25165,7,238
1,4,1508,85373,86881,8,60208
1,4,0,87227,87227,9,346
1,4,2419,95973,98392,10,8746
1,4,4550,98636,103186,11,244
1,4,3375,103775,107150,12,589
1,4,3286,107402,110688,13,252
1,4,2642,110937,113579,14,249
1,4,0,113935,113935,15,356
1,4,3503,114171,117674,16,236
1,4,592,187112,187704,17,69438
2,4,0,121,121,1,0
2,4,237,14639,14876,2,14518
2,4,0,22050,22050,3,7174
2,4,0,90378,90378,4,68328
2,4,473,90958,91431,5,580
2,4,111,91566,91677,6,135
2,4,360,92056,92416,7,379
2,4,1331,92654,93985,8,238
2,4,1362,94114,95476,9,129
2,4,235,95496,95731,10,20
2,4,748,96102,96850,11,371
2,4,619,97184,97803,12,334
2,4,1058,98052,99110,13,249
2,4,233,99706,99939,14,596
2,4,0,103098,103098,15,3159
2,4,614,115840,116454,16,12742
2,4,113,119341,119454,17,2887
2,4,1685,202071,203756,18,82617
2,4,124,204351,204475,19,595
2,4,623,204823,205446,20,348
2,4,0,209314,209314,21,3868
2,4,240,210139,210379,22,825
2,4,235,211103,211338,23,724
2,4,7,355009,355016,24,143671
3,4,349,236,585,1,0
3,4,1170,87282,88452,2,86697
3,4,1460,88696,90156,3,244
3,4,1064,90498,91562,4,342
3,4,958,91818,92776,5,256
3,4,3672,93020,96692,6,244
3,4,123,96941,97064,7,249
3,4,363,97654,98017,8,590
3,4,603,98255,98858,9,238
3,4,6459,99202,105661,10,344
3,4,3799,106032,109831,11,371
3,4,3830,110079,113909,12,248
3,4,346,114149,114495,13,240
3,4,246,115097,115343,14,602
3,4,14,115704,115718,15,361
3,4,221,115962,116183,16,244
3,4,0,116438,116438,17,255
3,4,3080,195949,199029,18,79511
3,4,240,199405,199645,19,376
3,4,851,199883,200734,20,238
3,4,372,201205,201577,21,471
3,4,488,201925,202413,22,348
3,4,124,203013,203137,23,600
3,4,355,203370,203725,24,233
3,4,361,205419,205780,25,1694
3,4,0,206881,206881,26,1101
3,4,1564,207240,208804,27,359
3,4,0,209286,209286,28,482
3,4,1310,209763,211073,29,477
5,4,1187,121,1308,1,0
5,4,0,1664,1664,2,356
5,4,486,2017,2503,3,353
5,4,1542,2961,4503,4,458
5,4,372,4874,5246,5,371
5,4,1694,5384,7078,6,138
5,4,5726,7427,13153,7,349
5,4,0,13282,13282,8,129
5,4,2234,13407,15641,9,125
5,4,3115,15766,18881,10,125
5,4,358,22762,23120,11,3881
6,4,115,121,236,1,0
6,4,0,3535,3535,2,3299
6,4,119,4016,4135,3,481
6,4,7,4745,4752,4,610
6,4,3938,6359,10297,5,1607
6,4,128,12439,12567,6,2142
6,4,110,13050,13160,7,483
6,4,123,13285,13408,8,125
6,4,0,13661,13661,9,253
6,4,0,14168,14168,10,507
6,4,503,15134,15637,11,966
6,4,0,15882,15882,12,245
6,4,0,16260,16260,13,378
6,4,362,16874,17236,14,614
6,4,116,17588,17704,15,352
6,4,0,19113,19113,16,1409
6,4,119,89899,90018,17,70786
6,4,0,90368,90368,18,350
6,4,114,91080,91194,19,712
6,4,2657,92186,94843,20,992
6,4,530,95335,95865,21,492
6,4,0,96104,96104,22,239
6,4,1936,96588,98524,23,484
6,4,0,98891,98891,24,367
6,4,0,102988,102988,25,4097
6,4,0,104289,104289,26,1301
6,4,0,104898,104898,27,609
6,4,0,105468,105468,28,570
6,4,7,105934,105941,29,466
6,4,0,106534,106534,30,593
6,4,0,106905,106905,31,371
7,4,2358,1785,4143,1,0
7,4,1486,4509,5995,2,366
7,4,828,6124,6952,3,129
7,4,111,7294,7405,4,342
7,4,855,8002,8857,5,597
7,4,7,15636,15643,6,6779
7,4,0,18656,18656,7,3013
7,4,0,20086,20086,8,1430
7,4,0,20704,20704,9,618
7,4,0,258902,258902,10,238198
7,4,0,262144,262144,11,3242
7,4,0,267946,267946,12,5802
7,4,116,269380,269496,13,1434
7,4,0,271884,271884,14,2388
7,4,0,272340,272340,15,456
7,4,0,272600,272600,16,260
8,4,0,3180,3180,1,0
8,4,0,4018,4018,2,838
8,4,0,4376,4376,3,358
8,4,0,4510,4510,4,134
8,4,0,4752,4752,5,242
8,4,0,11596,11596,6,6844
8,4,710,11939,12649,7,343
8,4,1615,12900,14515,8,251
8,4,0,15380,15380,9,865
8,4,111,15636,15747,10,256
8,4,591,15872,16463,11,125
8,4,231,16798,17029,12,335
8,4,934,17516,18450,13,487
8,4,863,18569,19432,14,119
8,4,727,19571,20298,15,139
8,4,696,20663,21359,16,365
8,4,0,21619,21619,17,260
8,4,611,21857,22468,18,238
8,4,0,22811,22811,19,343
8,4,351,23058,23409,20,247
8,4,128,24432,24560,21,1023
8,4,0,25869,25869,22,1309
8,4,0,26718,26718,23,849
8,4,0,28377,28377,24,1659
8,4,0,29215,29215,25,838
8,4,0,347250,347250,26,318035
8,4,0,347961,347961,27,711
8,4,0,349537,349537,28,1576
8,4,1371,350137,351508,29,600
8,4,724,351973,352697,30,465
8,4,241,353038,353279,31,341
8,4,246,353635,353881,32,356
8,4,113,354466,354579,33,585
8,4,369,354942,355311,34,363
8,4,121,355561,355682,35,250
9,4,1844,86488,88332,1,0
9,4,4,88693,88697,2,361
9,4,240,89068,89308,3,371
9,4,1888,89676,91564,4,368
9,4,252,91821,92073,5,257
9,4,491,92414,92905,6,341
9,4,233,93264,93497,7,359
9,4,1482,93747,95229,8,250
9,4,0,115736,115736,9,20507
9,4,488,186518,187006,10,70782
9,4,251,195172,195423,11,8166
9,4,4276,195768,200044,12,345
9,4,0,200284,200284,13,240
9,4,492,200522,201014,14,238
9,4,477,201251,201728,15,237
9,4,233,202094,202327,16,366
9,4,0,202802,202802,17,475
9,4,599,204247,204846,18,1445
9,4,482,205097,205579,19,251
9,4,365,205936,206301,20,357
9,4,363,206785,207148,21,484
9,4,486,207520,208006,22,372
9,4,236,208613,208849,23,607
9,4,0,209323,209323,24,474
9,4,466,209809,210275,25,486
1,5,343,121,464,1,0
1,5,116,700,816,2,236
1,5,588,7542,8130,3,6726
1,5,125,8742,8867,4,612
1,5,125,9228,9353,5,361
1,5,115,9598,9713,6,245
1,5,0,9957,9957,7,244
1,5,716,10195,10911,8,238
1,5,337,11157,11494,9,246
1,5,832,12069,12901,10,575
1,5,0,13030,13030,11,129
1,5,511,13282,13793,12,252
1,5,0,14261,14261,13,468
1,5,868,15136,16004,14,875
1,5,1655,16129,17784,15,125
1,5,225,21770,21995,16,3986
2,5,7,18157,18164,1,0
2,5,0,21928,21928,2,3764
2,5,0,338556,338556,3,316628
2,5,0,341776,341776,4,3220
2,5,0,342522,342522,5,746
2,5,0,343242,343242,6,720
2,5,114,343604,343718,7,362
2,5,0,344197,344197,8,479
2,5,474,344544,345018,9,347
2,5,0,346790,346790,10,1772
2,5,0,359311,359311,11,12521
3,5,0,236,236,1,0
3,5,0,585,585,2,349
3,5,0,816,816,3,231
4,5,1312,121,1433,1,0
4,5,1290,1908,3198,2,475
4,5,600,3675,4275,3,477
4,5,5529,4641,10170,4,366
4,5,1033,10656,11689,5,486
4,5,351,11931,12282,6,242
4,5,143,12526,12669,7,244
4,5,249,13382,13631,8,713
4,5,114,14004,14118,9,373
4,5,0,14245,14245,10,127
4,5,120,14609,14729,11,364
4,5,0,14964,14964,12,235
4,5,116,15437,15553,13,473
4,5,4,15884,15888,14,331
4,5,1296,16236,17532,15,348
4,5,491,17664,18155,16,132
4,5,240,18404,18644,17,249
4,5,390,22610,23000,18,3966
6,5,1190,3058,4248,1,0
6,5,1885,6359,8244,2,2111
6,5,486,8612,9098,3,368
6,5,593,9474,10067,4,376
6,5,0,10424,10424,5,357
6,5,121,11862,11983,6,1438
7,5,4,262144,262148,1,0
7,5,0,270691,270691,2,8543
7,5,0,271884,271884,3,1193
7,5,7,272600,272607,4,716
8,5,711,3060,3771,1,0
8,5,119,4018,4137,2,247
8,5,1,4380,4381,3,243
8,5,0,4880,4880,4,499
8,5,0,11483,11483,5,6603
8,5,0,11816,11816,6,333
8,5,0,14384,14384,7,2568
8,5,0,14760,14760,8,376
8,5,0,16910,16910,9,2150
8,5,0,17521,17521,10,611
8,5,0,19065,19065,11,1544
8,5,0,19437,19437,12,372
8,5,0,21116,21116,13,1679
8,5,0,337430,337430,14,316314
8,5,0,341251,341251,15,3821
8,5,7,342109,342116,16,858
8,5,0,342592,342592,17,476
8,5,365,344253,344618,18,1661
8,5,0,344979,344979,19,361
8,5,0,350997,350997,20,6018
8,5,0,351496,351496,21,499
8,5,7,354942,354949,22,3446
8,5,0,355675,355675,23,726
9,5,0,121,121,1,0
1,6,7,74547,74554,1,0
1,6,0,103186,103186,2,28632
2,6,117,347,464,1,0
2,6,0,940,940,2,476
2,6,124,1306,1430,3,366
2,6,0,1782,1782,4,352
2,6,0,91202,91202,5,89420
2,6,126,92181,92307,6,979
2,6,123,92531,92654,7,224
2,6,487,92893,93380,8,239
2,6,0,93861,93861,9,481
2,6,124,94109,94233,10,248
2,6,251,94468,94719,11,235
2,6,400,95215,95615,12,496
2,6,0,96464,96464,13,849
2,6,0,96602,96602,14,138
2,6,581,96850,97431,15,248
2,6,242,97803,98045,16,372
2,6,827,98283,99110,17,238
2,6,145,338284,338429,18,239174
2,6,821,344197,345018,19,5768
2,6,7,355009,355016,20,9991
3,6,0,585,585,1,0
3,6,348,88223,88571,2,87638
3,6,127,88826,88953,3,255
3,6,2758,89308,92066,4,355
3,6,2181,92412,94593,5,346
3,6,136,94729,94865,6,136
3,6,120,95112,95232,7,247
4,6,0,464,464,1,0
4,6,0,3198,3198,2,2734
4,6,351,3675,4026,3,477
4,6,982,4275,5257,4,249
4,6,371,5394,5765,5,137
4,6,1186,6247,7433,6,482
4,6,0,11233,11233,7,3800
4,6,127,12545,12672,8,1312
4,6,0,13631,13631,9,959
4,6,0,14482,14482,10,851
4,6,0,86927,86927,11,72445
4,6,0,87398,87398,12,471
4,6,0,87995,87995,13,597
4,6,0,88123,88123,14,128
4,6,123,89089,89212,15,966
4,6,1326,89453,90779,16,241
4,6,252,91152,91404,17,373
4,6,368,91417,91785,18,13
4,6,125,92031,92156,19,246
4,6,344,92405,92749,20,249
4,6,1176,93372,94548,21,623
4,6,465,94912,95377,22,364
4,6,595,95505,96100,23,128
4,6,123,99829,99952,24,3729
4,6,110,100536,100646,25,584
4,6,0,102571,102571,26,1925
4,6,0,103215,103215,27,644
4,6,0,104069,104069,28,854
5,6,0,464,464,1,0
5,6,116,702,818,2,238
5,6,0,1904,1904,3,1086
5,6,2084,3657,5741,4,1753
5,6,831,6130,6961,5,389
5,6,112,7315,7427,6,354
5,6,0,8495,8495,7,1068
7,6,0,1901,1901,1,0
7,6,808,2034,2842,2,133
7,6,0,3188,3188,3,346
7,6,0,3538,3538,4,350
7,6,0,4256,4256,5,718
7,6,623,4886,5509,6,630
7,6,240,5884,6124,7,375
7,6,1050,6952,8002,8,828
7,6,0,8620,8620,9,618
7,6,0,9826,9826,10,1206
7,6,0,15770,15770,11,5944
7,6,0,16021,16021,12,251
7,6,0,270685,270685,13,254664
8,6,0,121,121,1,0
8,6,235,464,699,2,343
8,6,244,938,1182,3,239
8,6,0,2252,2252,4,1070
8,6,1641,2609,4250,5,357
8,6,114,4510,4624,6,260
8,6,238,4756,4994,7,132
8,6,128,5126,5254,8,132
8,6,1440,11596,13036,9,6342
8,6,1218,13172,14390,10,136
8,6,255,14760,15015,11,370
8,6,127,15139,15266,12,124
8,6,362,15510,15872,13,244
8,6,468,16111,16579,14,239
8,6,1906,16910,18816,15,331
8,6,1124,19174,20298,16,358
8,6,575,20541,21116,17,243
8,6,358,21619,21977,18,503
8,6,0,337913,337913,19,315936
8,6,0,339356,339356,20,1443
8,6,231,340067,340298,21,711
8,6,7,341251,341258,22,953
8,6,122,341396,341518,23,138
8,6,251,341858,342109,24,340
8,6,241,342351,342592,25,242
8,6,0,343425,343425,26,833
8,6,499,344007,344506,27,582
8,6,1672,344862,346534,28,356
8,6,855,346883,347738,29,349
8,6,118,349419,349537,30,1681
8,6,607,349899,350506,31,362
8,6,0,350748,350748,32,242
8,6,0,350887,350887,33,139
8,6,0,351247,351247,34,360
8,6,130,351501,351631,35,254
8,6,0,351973,351973,36,342
8,6,0,352580,352580,37,607
8,6,1540,353279,354819,38,699
8,6,480,355074,355554,39,255
9,6,346,87525,87871,1,0
9,6,0,88103,88103,2,232
9,6,249,88444,88693,3,341
9,6,486,88947,89433,4,254
9,6,0,89795,89795,5,362
9,6,0,90845,90845,6,1050
9,6,111,91331,91442,7,486
9,6,2066,92414,94480,8,972
1,7,225,7428,7653,1,0
1,7,123,8007,8130,2,354
1,7,0,11726,11726,3,3596
1,7,0,12680,12680,4,954
1,7,614,13415,14029,5,735
1,7,0,15390,15390,6,1361
1,7,0,15885,15885,7,495
1,7,0,16135,16135,8,250
1,7,124,17660,17784,9,1525
1,7,116,21879,21995,10,4095
1,7,0,80039,80039,11,58044
1,7,473,80408,80881,12,369
1,7,372,82825,83197,13,1944
1,7,135,84157,84292,14,960
1,7,0,85127,85127,15,835
1,7,0,96335,96335,16,11208
1,7,0,96949,96949,17,614
1,7,0,99223,99223,18,2274
1,7,7,101990,101997,19,2767
1,7,0,102484,102484,20,487
1,7,0,103424,103424,21,940
1,7,0,104510,104510,22,1086
1,7,232,105080,105312,23,570
1,7,0,105789,105789,24,477
1,7,371,106146,106517,25,357
1,7,129,107000,107129,26,483
1,7,0,108266,108266,27,1137
2,7,111,236,347,1,0
2,7,369,816,1185,2,469
2,7,0,1662,1662,3,477
2,7,0,1893,1893,4,231
2,7,0,2370,2370,5,477
2,7,0,2952,2952,6,582
2,7,7,3648,3655,7,696
2,7,123,4013,4136,8,358
2,7,0,12805,12805,9,8669
2,7,0,17826,17826,10,5021
2,7,369,19951,20320,11,2125
2,7,230,84312,84542,12,63992
2,7,0,85751,85751,13,1209
2,7,130,92056,92186,14,6305
2,7,4,92527,92531,15,341
2,7,601,92779,93380,16,248
2,7,2241,93861,96102,17,481
2,7,974,96464,97438,18,362
2,7,1076,97803,98879,19,365
2,7,822,102502,103324,20,3623
2,7,0,104159,104159,21,835
2,7,252,106523,106775,22,2364
2,7,133,107132,107265,23,357
2,7,7,107653,107660,24,388
2,7,248,107909,108157,25,249
2,7,0,108524,108524,26,367
2,7,126,109517,109643,27,993
2,7,0,109868,109868,28,225
2,7,0,110222,110222,29,354
2,7,503,110574,111077,30,352
2,7,0,111693,111693,31,616
2,7,249,111942,112191,32,249
2,7,21,339018,339039,33,226827
2,7,0,340727,340727,34,1688
2,7,0,342522,342522,35,1795
2,7,142,343100,343242,36,578
2,7,0,344544,344544,37,1302
2,7,350,348975,349325,38,4431
2,7,234,349693,349927,39,368
2,7,7,350288,350295,40,361
2,7,473,350552,351025,41,257
2,7,260,351263,351523,42,238
2,7,0,352013,352013,43,490
2,7,0,353339,353339,44,1326
2,7,455,353596,354051,45,257
2,7,135,354763,354898,46,712
2,7,0,355130,355130,47,232
2,7,237,355833,356070,48,703
2,7,0,356439,356439,49,369
2,7,0,357748,357748,50,1309
2,7,371,358719,359090,51,971
3,7,735,88337,89072,1,0
3,7,723,89433,90156,2,361
3,7,471,90498,90969,3,342
3,7,364,91320,91684,4,351
3,7,2291,91941,94232,5,257
3,7,242,94481,94723,6,249
3,7,131,94865,94996,7,142
3,7,3,95232,95235,8,236
3,7,242,96699,96941,9,1464
3,7,246,97778,98024,10,837
3,7,342,98737,99079,11,713
3,7,237,99323,99560,12,244
3,7,0,100537,100537,13,977
3,7,129,101870,101999,14,1333
3,7,1786,102355,104141,15,356
3,7,0,105061,105061,16,920
3,7,117,105428,105545,17,367
3,7,132,106257,106389,18,712
3,7,131,106658,106789,19,269
3,7,131,107035,107166,20,246
3,7,0,107667,107667,21,501
3,7,131,108161,108292,22,494
4,7,1995,2161,4156,1,0
4,7,750,4514,5264,2,358
4,7,387,5633,6020,3,369
4,7,7,6247,6254,4,227
4,7,595,6610,7205,5,356
4,7,1075,7547,8622,6,342
4,7,6,13491,13497,7,4869
4,7,120,13631,13751,8,134
4,7,0,18766,18766,9,5015
4,7,0,22617,22617,10,3851
4,7,1328,88966,90294,11,66349
4,7,3541,90537,94078,12,243
4,7,1198,94663,95861,13,585
4,7,0,96100,96100,14,239
4,7,0,107245,107245,15,11145
4,7,0,109018,109018,16,1773
5,7,4,1897,1901,1,0
5,7,476,2260,2736,2,359
5,7,949,3073,4022,3,337
5,7,619,4503,5122,4,481
5,7,364,5384,5748,5,262
5,7,231,6010,6241,6,262
5,7,1405,6844,8249,7,603
5,7,492,8613,9105,8,364
5,7,0,15004,15004,9,5899
5,7,0,17800,17800,10,2796
5,7,117,18990,19107,11,1190
5,7,242,19341,19583,12,234
5,7,987,19833,20820,13,250
5,7,0,21313,21313,14,493
5,7,250,21676,21926,15,363
5,7,250,22258,22508,16,332
5,7,115,23238,23353,17,730
6,7,228,236,464,1,0
6,7,0,699,699,2,235
6,7,123,1061,1184,3,362
6,7,109,1552,1661,4,368
6,7,0,1905,1905,5,244
6,7,5,2133,2138,6,228
6,7,0,2832,2832,7,694
6,7,0,8975,8975,8,6143
6,7,0,88557,88557,9,79582
6,7,111,92416,92527,10,3859
6,7,0,92902,92902,11,375
6,7,1457,93259,94716,12,357
6,7,127,95089,95216,13,373
6,7,767,95464,96231,14,248
6,7,1572,97315,98887,15,1084
6,7,0,99122,99122,16,235
6,7,0,106301,106301,17,7179
8,7,352,236,588,1,0
8,7,0,938,938,2,350
8,7,233,1429,1662,3,491
8,7,0,1781,1781,4,119
8,7,692,2027,2719,5,246
8,7,0,16914,16914,6,14195
8,7,0,344625,344625,7,327711
9,7,122,87285,87407,1,0
9,7,223,87762,87985,2,355
9,7,115,88217,88332,3,232
9,7,0,88574,88574,4,242
9,7,0,88947,88947,5,373
9,7,1902,89308,91210,6,361
9,7,1457,91564,93021,7,354
9,7,362,93385,93747,8,364
9,7,486,93994,94480,9,247
1,8,0,121,121,1,0
1,8,0,585,585,2,464
1,8,0,1662,1662,3,1077
1,8,133,2025,2158,4,363
1,8,0,2387,2387,5,229
1,8,226,2969,3195,6,582
1,8,0,4030,4030,7,835
1,8,124,5130,5254,8,1100
1,8,230,5517,5747,9,263
1,8,346,6019,6365,10,272
1,8,0,6605,6605,11,240
1,8,0,9476,9476,12,2871
1,8,0,10075,10075,13,599
1,8,8,10549,10557,14,474
1,8,0,11033,11033,15,476
1,8,0,15508,15508,16,4475
1,8,109,17207,17316,17,1699
1,8,0,18398,18398,18,1082
1,8,0,19090,19090,19,692
1,8,0,27102,27102,20,8012
1,8,0,258123,258123,21,231021
1,8,0,258501,258501,22,378
1,8,0,262612,262612,23,4111
1,8,0,265106,265106,24,2494
2,8,0,121,121,1,0
2,8,1314,585,1899,2,464
2,8,124,2603,2727,3,704
2,8,0,337330,337330,4,334603
2,8,152,338277,338429,5,947
2,8,0,338779,338779,6,350
2,8,7,340727,340734,7,1948
2,8,0,344308,344308,8,3574
2,8,0,351888,351888,9,7580
2,8,0,355009,355009,10,3121
3,8,579,121,700,1,0
3,8,0,19143,19143,2,18443
4,8,226,121,347,1,0
4,8,0,819,819,2,472
4,8,0,1665,1665,3,846
4,8,0,8379,8379,4,6714
4,8,489,8622,9111,5,243
4,8,0,9590,9590,6,479
4,8,114,9944,10058,7,354
4,8,820,10182,11002,8,124
4,8,0,11233,11233,9,231
4,8,0,11931,11931,10,698
4,8,5,12277,12282,11,346
4,8,0,12539,12539,12,257
4,8,464,13030,13494,13,491
4,8,246,13751,13997,14,257
4,8,0,14118,14118,15,121
4,8,600,14485,15085,16,367
4,8,0,15437,15437,17,352
4,8,0,15772,15772,18,335
4,8,362,16127,16489,19,355
4,8,109,16717,16826,20,228
4,8,484,17060,17544,21,234
4,8,0,18286,18286,22,742
4,8,0,18530,18530,23,244
4,8,3,18766,18769,24,236
4,8,357,19009,19366,25,240
4,8,115,20433,20548,26,1067
4,8,0,20924,20924,27,376
4,8,249,21394,21643,28,470
4,8,127,22114,22241,29,471
4,8,0,23240,23240,30,999
4,8,0,23591,23591,31,351
4,8,0,23847,23847,32,256
4,8,119,24293,24412,33,446
4,8,114,26087,26201,34,1675
5,8,943,121,1064,1,0
5,8,0,1664,1664,2,600
5,8,0,8495,8495,3,6831
5,8,0,8868,8868,4,373
5,8,0,9712,9712,5,844
5,8,0,10677,10677,6,965
5,8,119,10917,11036,7,240
5,8,0,11395,11395,8,359
5,8,0,11744,11744,9,349
5,8,0,13042,13042,10,1298
5,8,252,13287,13539,11,245
5,8,130,15011,15141,12,1472
5,8,120,15766,15886,13,625
5,8,119,16137,16256,14,251
5,8,586,16879,17465,15,623
5,8,0,18403,18403,16,938
6,8,578,121,699,1,0
6,8,491,1061,1552,2,362
6,8,0,1893,1893,3,341
6,8,1657,2717,4374,4,824
6,8,248,4745,4993,5,371
6,8,2891,11513,14404,6,6520
6,8,383,14756,15139,7,352
6,8,121,15509,15630,8,370
6,8,5189,15882,21071,9,252
6,8,126,21680,21806,10,609
6,8,0,22272,22272,11,466
7,8,0,270685,270685,1,0
9,8,0,121,121,1,0
1,9,0,940,940,1,0
1,9,0,87118,87118,2,86178
1,9,0,115094,115094,3,27976
1,9,0,115828,115828,4,734
1,9,111,116447,116558,5,619
1,9,0,173079,173079,6,56521
1,9,7,175935,175942,7,2856
1,9,0,180059,180059,8,4117
1,9,966,180207,181173,9,148
1,9,0,181638,181638,10,465
1,9,0,183093,183093,11,1455
1,9,0,183568,183568,12,475
1,9,0,185865,185865,13,2297
1,9,0,186852,186852,14,987
1,9,0,187576,187576,15,724
1,9,128,187830,187958,16,254
1,9,0,188542,188542,17,584
2,9,0,21802,21802,1,0
2,9,119,90490,90609,2,68688
2,9,4300,91431,95731,3,822
2,9,1829,96102,97931,4,371
2,9,832,98393,99225,5,462
2,9,110,99706,99816,6,481
2,9,0,100299,100299,7,483
2,9,0,108410,108410,8,8111
2,9,604,116584,117188,9,8174
2,9,1075,202198,203273,10,85010
2,9,362,204468,204830,11,1195
2,9,0,205194,205194,12,364
2,9,0,205323,205323,13,129
2,9,127,209547,209674,14,4224
2,9,110,210029,210139,15,355
2,9,0,210634,210634,16,495
2,9,117,211221,211338,17,587
2,9,479,254308,254787,18,42970
2,9,941,255021,255962,19,234
2,9,1204,256088,257292,20,126
2,9,853,257650,258503,21,358
2,9,7,258983,258990,22,480
2,9,1071,259248,260319,23,258
2,9,4786,260690,265476,24,371
2,9,1557,265849,267406,25,373
2,9,629,267661,268290,26,255
2,9,818,268429,269247,27,139
2,9,0,270420,270420,28,1173
2,9,2043,271628,273671,29,1208
2,9,4793,274028,278821,30,357
2,9,495,338284,338779,31,59463
2,9,0,344308,344308,32,5529
2,9,7,350288,350295,33,5980
2,9,0,358004,358004,34,7709
3,9,5907,1062,6969,1,0
3,9,2288,7323,9611,2,354
3,9,361,9963,10324,3,352
3,9,1210,10680,11890,4,356
3,9,4665,12233,16898,5,343
3,9,5516,17254,22770,6,356
3,9,1920,23024,24944,7,254
3,9,2326,25308,27634,8,364
3,9,0,27985,27985,9,351
3,9,3080,28245,31325,10,260
3,9,1454,31561,33015,11,236
3,9,970,33378,34348,12,363
3,9,2348,34686,37034,13,338
3,9,4878,37385,42263,14,351
3,9,3131,42517,45648,15,254
3,9,8132,46010,54142,16,362
3,9,2034,54386,56420,17,244
3,9,484,56668,57152,18,248
3,9,2422,57514,59936,19,362
3,9,1570,60179,61749,20,243
3,9,1530,62096,63626,21,347
3,9,4172,63965,68137,22,339
3,9,6686,68502,75188,23,365
3,9,3033,75437,78470,24,249
3,9,1578,78612,80190,25,142
3,9,2300,80680,82980,26,490
3,9,6209,83224,89433,27,244
3,9,233,89796,90029,28,363
3,9,0,90379,90379,29,350
3,9,1453,91091,92544,30,712
3,9,121,92899,93020,31,355
3,9,1102,93495,94597,32,475
3,9,1248,94729,95977,33,132
3,9,365,116824,117189,34,20847
3,9,1169,117542,118711,35,353
3,9,10900,119294,130194,36,583
3,9,253,130905,131158,37,711
3,9,4506,131400,135906,38,242
3,9,3591,136146,139737,39,240
3,9,1088,139998,141086,40,261
3,9,0,141211,141211,41,125
3,9,21,141575,141596,42,364
3,9,5302,141854,147156,43,258
3,9,1398,147514,148912,44,358
3,9,500,149278,149778,45,366
3,9,997,150021,151018,46,243
3,9,1467,151378,152845,47,360
3,9,1191,152994,154185,48,149
3,9,0,154438,154438,49,253
3,9,1446,154809,156255,50,371
3,9,825,156735,157560,51,480
3,9,2764,157908,160672,52,348
3,9,608,160920,161528,53,248
3,9,7746,161896,169642,54,368
3,9,1579,189734,191313,55,20092
3,9,3799,191452,195251,56,139
3,9,351,195605,195956,57,354
3,9,1645,196193,197838,58,237
3,9,0,198078,198078,59,240
3,9,14,199267,199281,60,1189
3,9,846,199529,200375,61,248
3,9,833,200855,201688,62,480
3,9,7,202163,202170,63,475
3,9,4230,203137,207367,64,967
3,9,1066,207618,208684,65,251
3,9,833,209058,209891,66,374
4,9,1336,88117,89453,1,0
4,9,121,89812,89933,2,359
4,9,855,90170,91025,3,237
4,9,386,91399,91785,4,374
4,9,119,92031,92150,5,246
4,9,582,92291,92873,6,141
4,9,253,93119,93372,7,246
4,9,2644,94199,96843,8,827
4,9,120,117343,117463,9,20500
4,9,599,188093,188692,10,70630
5,9,4,1784,1788,1,0
5,9,0,1904,1904,2,116
6,9,1073,92186,93259,1,0
6,9,0,93623,93623,2,364
6,9,374,93983,94357,3,360
6,9,251,94716,94967,4,359
6,9,122,95335,95457,5,368
6,9,0,95739,95739,6,282
6,9,248,96104,96352,7,365
6,9,1810,96714,98524,8,362
6,9,235,98887,99122,9,363
7,9,832,1785,2617,1,0
7,9,1799,2954,4753,2,337
7,9,3733,5124,8857,3,371
7,9,0,19837,19837,4,10980
7,9,0,22258,22258,5,2421
7,9,0,262144,262144,6,239886
7,9,0,269159,269159,7,7015
7,9,0,269496,269496,8,337
8,9,0,4381,4381,1,0
8,9,4,4752,4756,2,371
8,9,111,337542,337653,3,332786
8,9,1097,337899,338996,4,246
8,9,0,339356,339356,5,360
8,9,575,339952,340527,6,596
8,9,14,340650,340664,7,123
8,9,126,341015,341141,8,351
8,9,7,341382,341389,9,241
8,9,110,341748,341858,10,359
8,9,369,342102,342471,11,244
8,9,468,342950,343418,12,479
8,9,118,343774,343892,13,356
8,9,0,344253,344253,14,361
8,9,0,344625,344625,15,372
8,9,234,345204,345438,16,579
8,9,369,346043,346412,17,605
8,9,357,347007,347364,18,595
8,9,122,347616,347738,19,252
8,9,236,349537,349773,20,1799
8,9,7,350263,350270,21,490
8,9,0,350513,350513,22,243
8,9,110,352580,352690,23,2067
8,9,0,355682,355682,24,2992
